NO ./texture/pineapple.png
SO ./texture/apple.png
WE ./texture/peach_watermelon.png
EA ./texture/two_apples.png
F 232, 223, 213
C 244, 248, 251

        1111111111111111111111111
        1000000000000000000000001
        1000000000000000000000001
        1000000000000000000000001
111111111000000000000000000000001
1000000000000000000001D1100011111
10000000000000001100000010001
10000000000000001100000010001
1000000000000000110N000010001
10000000000000001100000010001
10000000000000001100000010001
1000000111000001110000001000111
10000001 1000001 100000010001
11111111 1111111 111111111111